###.###
###.###
##...##
##.@.##
#######
