###.###
###.###
##...##
##...##
#######
